R 800 600
NO ./images/open.xpm
SO ./images/open.xpm
WE ./images/open.xpm
EA ./images/open.xpm

S ./images/open.xpm
F 200,100,0
C 225,30,0

111 111111
101 10000111
101110000001
1000000N0001
100220000111
100220000111
100000000001
111000000001
111111111111
