
F 50, 50 ,50
C   25 , 240,  250  

NO  ./images/red.xpm
SO     ./images/greystone.xpm 
EA ./images/eagle.xpm
WE ./images/open.xpm


111 111111
101 10000111
101110000001
10000000W01
10011000000111
111000000001
111011000001
111111111111
