
F 50,50,50
C 255,255,25

NO  ./images/red.xpm
SO     ./images/greystone.xpm 
EA ./images/eagle.xpm
WE ./images/open.xpm


111 111111
101 10000111
101110000001
100000000W01
10011000000111
111000000001
111001100001
111111111111

