R 800 640
NO ./images/open.xpm
SO ./images/open.xpm
WE ./images/open.xpm
EA ./images/open.xpm

S ./images/open.xpm
F 200,100,0
C 225,30,0

111 111111
101 100001111
10111000000011111
10000000000000001
10022000000011111
1002200001111
100000N001111111
1110000000000001
1110000000000111
1000000000011111111
1111111000000001111
1000000001111111111
1111111111
