NO ./images/open.xpm
SO ./images/open.xpm
WE ./images/open.xpm
EA ./images/open.xpm

F 200,100,0
C 225,30,0

111 111111
101 10000111
101110000001
1000000W0001
10011000000111
100110000001
100000000001
111001100001
   11  1111111111
