
F 255,0,0
C 0,255,0

NO  ./images/red.xpm
SO     ./images/greystone.xpm 
WE ./images/open.xpm
EA ./images/eagle.xpm

111 111111
101 10000111
101110000001
100000000W01
10011000000111
100000000001
111000000001
111001100001
111111111111