NO ./images/red.xpm
SO ./images/tonneau.xpm
WE ./images/red.xpm
EA ./images/eagle.xpm

F 128,128,128
C 0,56,153

11111111111111
1000W001100011
10011001100011
10011001100111
100110000001
100000011001
111000011001
111001100001
111111111111