R 1280 720
NO ./images/open.xpm
SO ./images/open.xpm
WE ./images/open.xpm
EA ./images/open.xpm

S ./images/open.xpm
F 200,100,0
C 225,30,0

11111111111     11111111111
1110000000111111100000000011
1110000000111111111111100011
1000000011111100000000000001
1000000011111100000000000001
1000000011111100000000200001
1111101111111100000000000001
1000000000000000000000200001
100000000000000000N000000001
1000000000000000000000200001
1111111111111111111111111111
