NO ./images/red.xpm
SO ./images/tonneau.xpm
WE ./images/red.xpm
EA ./images/eagle.xpm

F 128,128,128
C 20,70,255

11111111111111
10000011000111
10011001100011
10011001100111
100110000001
1E0000011001
111000011001
111001100001
111111111111